------------
------------
---#H-B-----
-------#----
---#-B-#----
---#---T----
---#T###----
------------
------------
------------
------------
------------