#####----
#H--#----
#-BB#-###
#-B-#-#T#
###-###T#
-##----T#
-#---#--#
-#---####
-#####---